################
#....      #####
#....      #   #
#....  ### # $ #
#....  # ##$ $ #
#### ### #  $ ##
   #     $ $$ ##
 ### # ###$#  ##
 #   # # @  $ ##
 # $  $ $ $$  ##
 #   # #  $ ####
 ##### ##$###   
     #    #     
     ######     
