 ####
 #  #######
 # $  $   #
 # ##    .#
 #  #  ##.#
 #$ #$....#
 #  @  # ##
##$#####  #
#      $  #
#   ####  #
#####  ####
