 #######
 # .$ +#
 # . $$#
##$. * #
#  $* .#
#  .$  #
########