    #####
    #   #
    #$  #
  ###  $# 
  #  $ $ #
### # ## #   ######
#   # ## ##### ...#
# $  $  @   $ ...#
############## $..#
             ######
