####              
#  ###############
# $              #
# .############  #
## .*.*.*.*  ..## ##
# ........ *  ## # 
# ##$#$#### ### # 
#    $@     $ # # 
# $$# #$$$$$  # # 
#  $  $         # 
##############$ # 
              #  # 
              #### 
