       ######
       #    #
       #$   #
     ###   $##
     #  $  $ #
###### # ### ################################
#  ***   ***  *  *  ***  ****    *   *     *#
# *   * *   * *  * *   *  *  *  * *  **  # *#
# *     *   * * *  *   *  *  * *   * * *   *#####
#  *#*  # ### *#   ### #  #**  #***# #  #  #  ..#
#     * *   * * *  *   *  *  * *   * *   * *  ..#
# *$  * *   * *  * *   *  *  * * # * * #  **  ..#
#  *** $ ***  *  *  ***  ****  *   * *     *#####
####### ################ ####@###############
      #                  #  ###
      ####################
